MOL = "countries/Democratic Republic of Moldavia.txt"
VBH = "countries/Vereinigtes Baltisches Herzogtum.txt"
LIT = "countries/Grand Duchy of Lithuania.txt"
WHR = "countries/White Ruthenia.txt"
UKR = "countries/Grand Duchy of Ukraine.txt"
SOV = "countries/Russian Soviet Socialist Republic.txt"
RUS = "countries/Republic of Russia.txt"
KAZ = "countries/Kazakh Zhuz State.txt"
KYR = "countries/Republic of Fergana.txt"
TAJ = "countries/Bukhara Khanate.txt"
TMS = "countries/Khanate of Khiva.txt"
ROM = "countries/Kingdom of Romania.txt"
BUL = "countries/Tsardom of Bulgaria.txt"
GRE = "countries/The Hellenic Republic.txt"
DFN = "countries/Danube Federation.txt"
SER = "countries/Serbian National State.txt"
ALB = "countries/Republic of Albania.txt"
ITA = "countries/Kingdom of Italy.txt"
FIN = "countries/Kingdom of Finland.txt"
SWE = "countries/The Kingdom of Sweden.txt"
NOR = "countries/The Kingdom of Norway.txt"
DEN = "countries/The Kingdom of Denmark.txt"
ICE = "countries/The Republic of Iceland.txt"
GER = "countries/German Empire.txt"
HOL = "countries/The Netherlands.txt"
BEL = "countries/Kingdom of Belgium.txt"
SWI = "countries/Swiss Confederation.txt"
IRE = "countries/Republic of Ireland.txt"
NIR = "countries/Northern Ireland Military Territory.txt"
BRI = "countries/Republic of Brittany.txt"
BUD = "countries/Burgundy Free State.txt"
ENG = "countries/United Kingdom.txt"
FRA = "countries/French legionnaire state.txt"
POL = "countries/Kingdom of Poland.txt"
POR = "countries/The Portuguese Republic.txt"
SPR = "countries/Spanish Republic.txt"
GJP = "countries/The Governor-General's Office of Japan.txt"
JAP = "countries/Republic of Japan.txt"
RYU = "countries/Kingdom of the Ryukyus.txt"
CHA = "countries/The emergence of the United States of Chunghwa.txt"
KOR = "countries/Kingdom of Korea.txt"
AGO = "countries/Annan Governor's Office.txt"
INS = "countries/dutch east indies.txt"
PHI = "countries/Republic of the Philippines.txt"
SIA = "countries/Kingdom of Siam.txt"
NGG = "countries/Nanyang Governor General's Office.txt"
NEP = "countries/Kingdom of Nepal .txt"
AFG = "countries/Kingdom of Afghanistan.txt"
ICS = "countries/Indian Confederation of Land States.txt"
IND = "countries/Republic of India.txt"
PAK = "countries/Islamic Republic of India.txt"
AST = "countries/Australian Dominion.txt"
NZL = "countries/New Zealand Dominion.txt"
OTO = "countries/the Ottoman Empire.txt"
PER = "countries/The Persians.txt"
OMA = "countries/The Sultanate of Oman.txt"
SAU = "countries/Nejd.txt"
YEM = "countries/Mutawakkilia Kingdom of Yemen.txt"
AFO = "countries/African Office.txt"
MTA = "countries/Mittelafrika .txt"
ETH = "countries/Ethiopian Empire.txt"
LIB = "countries/Republic of Liberia.txt"
SAF = "countries/Union of South Africa.txt"
MMR = "countries/Mau Mau Rebellion.txt"
BAF = "countries/British Africa.txt"
MOR = "countries/The Kingdom of Morocco.txt"
ARG = "countries/Republic of Argentina.txt"
BOL = "countries/Plurinational State of Bolivia.txt"
CHL = "countries/Republic of Chile.txt"
ECU = "countries/República del Ecuador.txt"
PAR = "countries/Republic of Paraguay.txt"
PRU = "countries/Republic of Peru.txt"
URG = "countries/Oriental Republic of Uruguay.txt"
DGA = "countries/Dutch Guiana.txt"
BRA = "countries/The Federative Republic of Brazil.txt"
COL = "countries/The Republic of Colombia.txt"
VEN = "countries/Bolivarian Republic of Venezuela.txt"
CAR = "countries/Commonwealth Caribbean.txt"
CAN = "countries/Dominion of Canada.txt"
MEX = "countries/The United Mexican States.txt"
USA = "countries/The United States of America.txt"
ROC = "countries/Republic of China.txt"
FAC = "countries/Union of French Algerian Communes.txt"
#美国内战势力
RMC = "countries/Royal Military Committee.txt"
USS = "countries/United Social States.txt"
NEE = "countries/New England E.txt"
FCC = "countries/Free CC.txt"
ASA = "countries/America SA.txt"	